C 		70 , 	122 		, 0166
		   	  	   R		 	 960			   	 640		
  	 	    	NO          		      	./textures/HD/Epic-Soul.xpm
			    	 	 	 	  
   		 	 	 	 SO  	 			       	./textures/musee_1.xpm
        WE                ./textures/HD/.xpm/dragon.xpm 	
			EA 								./textures/HD/peeper.xpm
		F      160  	 ,		    	110  		,50 			

        1111111111111111111111
        1000000000110000000001
        1011000001110000000000111
        1001000000000000000000001
111111111011000001110000000000001
100000000011000001110111110111111
11110111111111011100000010001
11110111111111011100010010001
110000001101010111000000100011111111
100000000000000011000000100000000001
1000E0000000000011010100100000000001
11000001110101011111011110000000000111
11110111 1110101 101011010000111111
11111111 1111111 111111111111

	 	 	 
